**********
*P    *  *
*        *
*      E *
*  ***   *
*        *
*        *
*  *******
*       G*
**********